####################
#2#      #         #
# #      #         #
# #      # ####### #
# #      # #     # #
# ####   # #     # #
#    #   # #     # #
# ####  ## ##    # #
# #     #   #  ### #
# #     # E #  #   #
# #     #   #  ### #
# #     #####    # #
# #              # #
# #              # #
# #              # #
# #              # #
# #              # #
# ################ #
#                  #
####################
