####################
#2#//////#         #
# #//////#         #
# #//////# ####### #
# #//////# #/////# #
# ####///# #/////# #
#    #///# #/////# #
# ####//## ##////# #
# #/////#   #//### #
# #/////# E #//#   #
# #/////#   #//### #
# #/////#####////# #
# #//////////////# #
# #//////////////# #
# #//////////////# #
# #//////////////# #
# #//////////////# #
# ################ #
#                  #
####################
