11111111111111111111
1                  1
1                  1
1                  1
1                  1
1                  1
1                  1
1                  1
1                  1
1                  1
1                  1
1       1441       1
1      1111113     1
1 2   11111111     1
1 2  1111111111  3 1
11111111111111111111
11111111111111111111
11111111111111111111
11111111111111111111
11111111111111111111
11111111111111111111
1                  1
1                  1
1                  1
1                  1
1                  1
1  2   4     4   3 1
11111111111111111111
11111111111111111111
1                  1
1                  1
1                  1
1                  1
1                  1
1 2 4        4   3 1
11111111111111111111
11111111111111111111
11111111111111111111
11111111111111111111
11111111111111111111
11111111111111111111
1                  1
1                  1
1                  1
1                  1
1                  1
1                  1
1                  1
1                3 1
1                  1
1 2                1
1               4411
1                411
1                  1
1 2           4  3 1
11111111111111111111
11111111111111111111
11111111111111111111
11111111111111111111
11111111111111111111
11111111111111111111
1                  1
1                  1
1                  1
1                  1
1                  1
1                  1
1                  1
1                  1
1                  1
1          1       1
1          1       1
1         21       1
1       1111       1
1 2        44444 3 1
11111111111111111111
11111111111111111111
11111111111111111111
11111111111111111111
11111111111111111111
11111111111111111111
11111111111111111111
11111111111111111111
1      3 2 4       1
11111111111111111111
1      4  2  3     1
11111111111111111111
1    3   2   4     1
11111111111111111111
1    4    2    3   1
11111111111111111111
1  3     2     4   1
11111111111111111111
1  4      2      3 1
11111111111111111111
11111111111111111111
11111111111111111111
11111111111111111111
11111111111111111111
11111111111111111111